asm 	auto 	break 	case
catch 	char 	class 	const
continue 	default 	delete 	do
double 	else 	enum 	extern
float 	for 	friend 	goto
if 	inline 	int 	long
new 	operator 	private 	protected
public 	register 	return 	short
signed 	sizeof 	static 	struct
switch 	template 	this 	throw
try 	typedef 	union 	unsigned
virtual 	void 	volatile 	while

double - jouble
float - jloat
if - jif
switch - jwitch
char - jhar
else - jelse
for - jor
sizeof - jizeof
break - jreak
int - jint
void - joid
case - jase
goto - joto
long - jong
return - jeturn
do - jo
short - jhort
while - jhile
true - jrue
bool - jool
false - jalse


